playerJoinMessage: "你进入了 %n% 领地 领主: %master% \n 成员: %member%"
playerQuitMessage: "你离开了 %n% 领地 领主: %master% \n 成员: %member%"
playerSetPos1: "已设置领地第一点 坐标 %pos% 点击另一点设置领地第二点"
playerSetPos2ErrorLevel: "两点不在同一个世界 请重新选择"
playerSetPos2Error: "请先设置第一点"
createNotHavePos: "请先圈地"
createNotHavePos2: "请先设置第二点"
playerQuitLandMessageTarget: "你退出了 %name% 领地.."
playerQuitLandMessageMaster: "玩家 %p% 退出了 %name% 领地.."
playerJoinLandMessageTarget: "你加入了 %name% 领地.."
playerJoinLandMessageMaster: "玩家 %p% 加入了 %name% 领地.."
position: "x: %x% y: %y% z: %z% level: %level%"
playerSetPos2: "已设置领地第二点 坐标 %pos%  当前领地价格为 %money% \n如果你的金钱充足 输/land create <名称>创建"
playerBuyLandSuccess: "成功购买领地 %name% 花费 %money%"
playerBuyLandError: "购买领地失败，，你没有足够的金钱"
playerBuyLandErrorLandExists: "领地 %name% 已经存在"
playerBuyLandErrorLandInArray: "与领地 %name%存在冲突 请重新选择"
playerLandMax: "领地已经到达上限啦.. 上限 %count%"
playerTransferLand: "你传送到了 %name% 领地"
landButtonText: "领地: %name% 身份: %p%\n点击查看详情"
master: "(领主)"
member: "(成员)"
other: "(访客)"
notHaveLand: "你还没有领地呢...快去创建一个吧"
landSettingMessage: "领地名称: %name% \n\n领主: %master% \n\n成员: %member%\n\n领地范围: \n%pos%\n\n所在地图: %level%"
pos: "x: %x1% -> %x2% y: %y1% -> %y2% z: %z1% -> %z2%"
quitLandButton: "离开领地"
sellLandButton: "出售领地 ( - %c% ％)"
transferButton: "传送到领地"
giveLandButton: "转让领地"
setTransfer: "设置传送点"
setLandButton: "领地设置"
setTextButton: "领地进服 / 退出提示"
choseCanSell: "你确定要出售这个领地吗 当前出售价格 %money% ( - %c% ％)"
choseQuitLand: "你确定要退出这个领地吗?"
labelText: "权限设置对象: %p%"
inviteButton: "邀请玩家"
kickButton: "踢出玩家"
kickLandMessage: "你被 %p% 踢出了 %name% 领地"
sellLandMessage: "你成功出售 %name% 领地 获得 %money%"
setPlayerButton: "玩家领地权限设置"
setOtherButton: "访客领地权限设置"
kickText: "你确定要将玩家 %p% 移除领地吗?"
giveText: "你确定要将领地 %n% 转让给玩家 %p%吗?"
acceptMessageMaster: "玩家 %p% 接受了你的 %name% 领地邀请.."
acceptErrorMaxMaster: "玩家 %p% 的领地已经到达上限 无法加入 %name%领地"
acceptErrorMaxTarget: "你的的领地已经到达上限啦..无法加入%n%的 %name%领地"
acceptMessageMember: "你加入了 %p% 的%name%领地..."
denyMessageMaster: "玩家 %p% 拒绝了你的 %name% 领地邀请.."
denyMessageMember: "你拒绝了 %p% 的领地邀请..."
notHaveInvite: "你没有任何领地邀请"
notHaveTargetInvite: "你没有 %p% 的领地邀请.."
inviteList: ">>========邀请列表=======<<\n%list%"
listValue: " %p% 邀请你加入 %name% 领地 (输/领地 accept <%p%> 同意邀请)"
notHavePermission: "你没有操作权限..."
choseTrue: "确定"
choseFalse: "取消"
saveSetting: "%p% 权限设置已保存.."
saveTransfer: "%name% 传送点已保存 "
saveText: "%name% 已保存"
saveTransferError: "请在 %name% 领地内设置传送点"
invitePlayerMaster: "成功向 %p% 发送了加入 %name% 领地邀请 (有效时间 %time% 秒)"
invitePlayerTarget: "%p% 向你发送了 %name% 领地邀请\n/领地 accept <%p%> 同意领地邀请\n/领地 deny <%p%> 拒绝邀请"
invitePlayerExists: "你已经邀请了 %p% 啦..."
invitePlayerInArray: "%p% 已经是 %name% 的成员啦."
dataNotExists: "%name% 领地不存在啦..."
playerOffOnline: "%p% 不在线~~"
givePlayerLandTarget: "%p% 将 %name% 领地赠送给你啦~"
givePlayerLandMaster: "你将 %name% 领地赠送给了 %p%~"
whiteWorld: "%level% 世界禁止圈地"
inputTextJoin: "请设置玩家进入领地的提示 %n% 代表领地名称 %master% 是领主 %member%是领地成员"
inputTextQuit: "请设置玩家离开领地的提示 %n% 代表领地名称 %master% 是领主 %member%是领地成员"
integerError: "请输入正确的数值"
mathLandMoney: "正在计算拓展领地需要花费的金钱..."
placeInLandData: "请站在领地内..."
expandNeedNotHaveMoney: "你的钱不够哦~~ 无法拓展领地 需要花费 %money%"
expandNeedSuccess: "成功拓展 %count% 格 %name% 领地 花费 %money%"